1111111111111111111111111111
1E0001000000000C00000C0001C1
1111110100100000101001000101
1111010010101010001001000101
1P0000000C00C000000000000001
1111111111111111111111111111