1111111111111111111111111111
1E000000000000C00000C0001C01
11111101001000001010010001C1
1111010010101010001001000101
1P0000000C00C000000000000001
1111111111111111111111111111