1111111111111111111111111111
1E00000000000000000000001001
1111110100100000101001000101
1111110010101010001001000101
1P0000000000000000000C000001
1111111111111111111111111111