1111
1P01
1111
1C01
1001
1E01
1111