1111111
1P0E0C1
1000001
1111111