11111111111
1P0000000C1
11111111101
1C000000001
11011111111
100000000E1
11111111111