11111111111
1P000C000C1
11111111101
1E00C0000C1
11111111111