11111111
1P0000C1
1E000001
11111111