1111111111111111111111111111111111111111111111111111111111111111111111111111111111111111111111111111111111111111111111111111111111111111111111111111111111111111111111111111111111111111111111111111111111111111111111111111111111111111111111
1E0000C00000C00000C00000C00000C00000C00000C00000C00000C00000C00000C00000C00000C00000C00000C00000C00000C00000C00000C00000C00000C00000C00000C00000C00000C00000C00000C00000C00000C00000C00000C00000C00000C00000C00000C00000C00000C00000C00000C001
100000C00000C00000C00000C00000C00000C00000C00000C00000C00000C00000C00000C00000C00000C00000C00000C00000C00000C00000C00000C00000C00000C00000C00000C00000C00000C00000C00000C00000C00000C00000C00000C00000C00000C00000C00000C00000C00000C00000C001
100000C00000C00000C00000C00000C00000C00000C00000C00000C00000C00000C00000C00000C00000C00000C00000C00000C00000C00000C00000C00000C00000C00000C00000C00000C00000C00000C00000C00000C00000C00000C00000C00000C00000C00000C00000C00000C00000C00000C001
100000C00000C00000C00000C00000C00000C00000C00000C00000C00000C00000C00000C00000C00000C00000C00000C00000C00000C00000C00000C00000C00000C00000C00000C00000C00000C00000C00000C00000C00000C00000C00000C00000C00000C00000C00000C00000C00000C00000C001
100000C00000C00000C00000C00000C00000C00000C00000C00000C00000C00000C00000C00000C00000C00000C00000C00000C00000C00000C00000C00000C00000C00000C00000C00000C00000C00000C00000C00000C00000C00000C00000C00000C00000C00000C00000C00000C00000C00000C001
100000C00000C00000C00000C00000C00000C00000C00000C00000C00000C00000C00000C00000C00000C00000C00000C00000C00000C00000C00000C00000C00000C00000C00000C00000C00000C00000C00000C00000C00000C00000C00000C00000C00000C00000C00000C00000C00000C00000C001
100000C00000C00000C00000C00000C00000C00000C00000C00000C00000C00000C00000C00000C00000C00000C00000C00000C00000C00000C00000C00000C00000C00000C00000C00000C00000C00000C00000C00000C00000C00000C00000C00000C00000C00000C00000C00000C00000C00000C001
