11111111111111
1P000000000001
111000000001C1
1E000001001111
11111111111111