11111111111111
1P0000000000C1
111000000000C1
1E000001000011
11111111111111